Cave
Gloomy Cavern
1
#####################
#      @     #  #  o#
# ########## #   @  #
# #        # #@######
###@### # ## #      #
#   # # #  #      #@#
# ### ####  ##### # #
# # #      @      # #
# # #############   #
#    @         o#@# #
#####################?
4
1