Forest
The Hundred Acre Wood
0
##################
#      @    #@   #
## ### #+## # ## #
# @     ##    # @#
# # ## @  # #   ##
# #   # #  #  #  #
# # # #  #  #@ # #
#@   # # @#  #  ##
# # #   # +#  #  #
# #   #  ## # ## #
# #### @      ##@#
#   @ #+# ####   #
# ###  # #@  # ###
##  # ##   #  @  #
#  # @ #  #  ### #
# ## #  # #@#    #
#  @ ## # # +#####
#### #  #  ##    #
#   @# # #  # ## #
#@ #+# @  # @   o#
##################?
1